BAL = "countries/Baltic Commonwealth.txt"
FIN = "countries/Finnish Khaganate.txt"
KIE = "countries/Kievan Rus.txt"
RUH = "countries/Russian Hegemony.txt"
DEA = "countries/Dead Circle.txt"
SAM = "countries/Grand Confederation of Samara.txt"
RUP = "countries/Principality of Russia.txt"
INW = "countries/Industrial Wasteland.txt"
THU = "countries/Thulean Brotherhood.txt"
USR = "countries/Union of Sycthian Republics.txt"
NRF = "countries/Nazbol.txt"
TTC = "countries/Turkic Tribal Confederation.txt"
I01 = "countries/Iron Lord 1.txt"
I02 = "countries/Iron Lord 2.txt"
I03 = "countries/Iron Lord 3.txt"
I04 = "countries/Iron Lord 4.txt"
I05 = "countries/Iron Lord 5.txt"
I06 = "countries/Iron Lord 6.txt"
I07 = "countries/Iron Lord 7.txt"
I08 = "countries/Iron Lord 8.txt"
I09 = "countries/Iron Lord 9.txt"
CLA = "countries/Clans of Scotland.txt"
RFM = "countries/Republic of Free Men.txt"
CRI = "countries/Realm of the Crimson King.txt"
CAM = "countries/Kingdom of Camelot.txt"
WCB = "countries/Wessex.txt"
LON = "countries/London Authority.txt"
BFS = "countries/British Fascist State.txt"
VLA = "countries/Vladivostok Directorate.txt"
FER = "countries/Far Eastern Republic.txt"
CHR = "countries/Lands of Christ.txt"
IRK = "countries/Host of Irkusts.txt"
GAZ = "countries/Gazprom Property.txt"
NIR = "countries/Nirvana.txt"
KAZ = "countries/Kazakh Khanate.txt"
SOL = "countries/Italian Solar Empire.txt"
KYU = "countries/Kyushu Republic.txt"
JAI = "countries/Empire of Japan.txt"
SMI = "countries/Sapmi.txt"
JMT = "countries/Jamtlann.txt"
NOR = "countries/Norge.txt"
GOT = "countries/Gothland.txt"
SWE = "countries/Sverige.txt"
SML = "countries/Smolandia.txt"
DEN = "countries/Danmark.txt"
DY1 = "countries/Daimyo 1.txt"
DY2 = "countries/Daimyo 2.txt"
DY3 = "countries/Daimyo 3.txt"
DY4 = "countries/Daimyo 4.txt"
DY5 = "countries/Daimyo 5.txt"
SLA = "countries/Slavic Empire.txt"
CRO = "countries/Croai Republic.txt"
SES = "countries/Serbian National State.txt"
SEK = "countries/Kingdom of Serbia.txt"
NRB = "countries/New Republic of Belgrade.txt"
SEC = "countries/Serb Confederation.txt"
SCI = "countries/Catholic State of Italy.txt"
TAI = "countries/Republic of Taiwan.txt"
CWU = "countries/Chinese Workers Union.txt"
PRC = "countries/People's Republic of China.txt"
JIA = "countries/Jiangsu Clique.txt"
GOB = "countries/Gobi Confederation.txt"
HKG = "countries/Hong Kong.txt"
YSG = "countries/Yunsheng Dynasty.txt"
IOC = "countries/Giao Chi Occupation Corps.txt"
XIN = "countries/Xinjiang Sultanate.txt"
TPR = "countries/Tibetian People's Republic.txt"
HUB = "countries/Kingdom of Hubei.txt"
GUI = "countries/Guizhou Authority.txt"
FUZ = "countries/Fuzhou Military Commision.txt"
RCC = "countries/Republic of Central China.txt"
SVI = "countires/South Vietnam.txt"
INF = "countries/Indochinese Federation.txt"
KOR = "countries/People's Republic of Korea.txt"
PRF = "countries/People's Republic of France.txt"
BRI = "countries/National Council of Brittany.txt"
FFT = "countries/Free French Territory.txt"
FRS = "countries/French State.txt"
SGR = "countries/South German Republic.txt"
EGE = "countries/German Democratic Republic.txt"
CSG = "countries/People's Front of Germany.txt"
SRE = "countries/New Aldebaran.txt"
DNS = "countries/Danish National State.txt"
FRI = "countries/Frisia.txt"
COL = "countries/Republic of Colombia.txt"
FAR = "countries/FARC.txt"
CAR = "countries/Caracas.txt"
ZUL = "countries/Trader Republic of Zulia.txt"
BRV = "countries/Bolivarian Republic of Venezuela.txt"
RIO = "countries/Riograndese Republic.txt"
SAN = "countries/San Paulo.txt"
EQU = "countries/Equatorial Confederation.txt"
AMA = "countries/Amazonas.txt"
ARE = "countries/ARENA.txt"
CUI = "countries/Cuiaba.txt"
PAL = "countries/Palmas.txt"
MAC = "countries/Macapa.txt"
PRU = "countries/Republic of Peru.txt"
SHI = "countries/Shinning Path.txt"
ACR = "countries/Acre.txt"
ESG = "countries/Ecuadorian Salvation Government.txt"
GAL = "countries/Galapagos Regime.txt"
KAT = "countries/Katarusta Rebellion.txt"
BOL = "countries/Bolivia.txt"
CHL = "countries/Republic of Chile.txt"
PAR = "countries/Republic of Paraguay.txt"
BUE = "countries/Buenos Aires.txt"
KIR = "countries/Kirchnerites.txt"
BIO = "countries/Biondinistas.txt"
ISA = "countries/Isabelites.txt"
MON = "countries/Montoneros.txt"
PAT = "countries/Patagonian Emergency Government.txt"
GUY = "countries/Guyana.txt"
KER = "countries/Cornwall.txt"
MNX = "countries/Mann.txt"
ULS = "countries/Kingdom of Ulster.txt"
FGB = "countries/Free Government of Britain.txt"
GRL = "countries/Greenland.txt"
ICE = "countries/Iceland.txt"
PSR = "countries/Pakastani SFSR.txt"
PUN = "countries/Union of Pakistan.txt"
IND = "countries/Republic of India.txt"
RAS = "countries/Rashtryia Gathbandhan.txt"
NEP = "countries/Nepal.txt"
RSS = "countries/Rashtriya Swayamsevak Sangh.txt"
BHA = "countries/Church of Bhagwan.txt"
AHN = "countries/countries/Ahndra-Tamil Pact.txt"
TRA = "countries/Kingdom of Travancore.txt"
CEY = "countries/Socialist Republic of Ceylon.txt"
IZM = "countries/Izmir.txt"
IST = "countries/Istanbul.txt"
ADA = "countries/Adana.txt"
KRN = "countries/North Korea.txt"
KRS = "countries/South Korea.txt"
UNI = "countries/Unification Movement.txt"
CAB = "countries/Republic of Cambodia.txt"
MYA = "countries/Union of Myanmar.txt"
LAO = "countries/Kingdom of Laos.txt"
KAR = "countries/Karen National Union.txt"
YAW = "countries/Yawnghwe.txt"
THA = "countries/Kingdom of Thailand.txt"
ISN = "countries/Isan Commune.txt"